SSSSSSSSSSSSSSSSSSSSSS
S44OOOOOOOOOOOS4OOO2SS
S3OOOOOOOOOOOOSSSOSSSS
SSSSSOSSSSOOOOOOOOOOOS
SO1OOOOOOOOOOO1OOOOOOS
SSSSSSSSSSSSOSOSOSSSSS
SOSSOSOO4OOSOSOOOSSS4S
SOOSOSSSSSOS4SSSSSOSOS
S1OOOOOOOOOOOOOOOOOOOS
SOOOOOOOO1OOOSSSSSSSSS
SOSSSSOOOOOOOSO4OOO4OS
SO4SOSOOOOOOOSOOOS4OOS
SSSSSSSOO1OOOSOOOOOOOS
S1OOOOOOOOOOO3SSSSOSSS
SOOOOOOOOOOOOOOOOOOO4S
SOSSSSSOOSSSSOOOOOOOOS
SOSOOOOOOOO4SOOOOOOOOS
SOOOSS4SOSSSSOOOOOOOOS
SOSSSSSSOOOOOOOOOOO44S
S4S4OSOO1OOOOOOOOOOOOS
SSSSSSSSSSSSSSSSSSSSSS