SSSSSSSSSSSSSSSSSSSSSS
SOOOOOOO1OOO1OSOOOOOOS
SOOO4OOOOO44OOSOO4OOOS
SSSSSSSOOOOOOOSOOO1OOS
SO1OOOOOOO1OOOSSSSSSOS
SOOO4O43OOOOOOOSOOOOOS
SOOOOOOSOOOOOOOSSSSOOS
SSSSSSOSOOOOOOOOOOOO3S
SOOOOOOSOOSSSSOOOOOOOS
SOOOSOOO4OOOSOOOO1OOOS
SOOOSO1OO1OOSOOOOOOOOS
SSSSSSSSSS4SSSSSSSSSSS
SOOO1OO1SSOSOOOOOOOOOS
SOOOSSSSSOOS44OOOO1OOS
SOOOSOOOOOOSSSSSSOOOOS
SOOOOOOSSSOOOOOOOOOOOS
SSSSSSS414OOOOSSSSSSSS
S3OOOOOOOOOOOOOOOOOOOS
SOOOOOSOOOOOOOOOOO2OOS
SOOOOOSOOOOO4OOOOOOOOS
SSSSSSSSSSSSSSSSSSSSSS