SSSSSSSSSSSSSSSSSSSSSS
S44OOOOOOOOOOOS4OOOO4S
S3OOOOOOOOOOOOSSSOSSSS
SSSSSOSSSSOOOOOOOOOO3S
S3OOOOOOOOO1OOOOOOOOOS
SSSSSSSSSSSSOSOSOSSSSS
SOSSOSOO4OOSOSOOOSSS4S
SO1SOSSSOOOS4SSSSSOSOS
SOOOOOOSOOSSOSOOOOOOOS
SOOOSOOO4OOOOOOO1OOO1S
SOOOS3OOOOOO1OOOOOOOOS
S4OOSOOOOOOOOOOOOOOO3S
SSSSSSSSSS4SSSSSSSSSSS
SOOOOOO1SSOSOOOOOOOOOS
SOOOSSSSSOOS44OO1O1OOS
SOOOOOOSSSOSOOOOOOOOOS
S3OOOOOOOOOSSSSSSSSOSS
SSSSSSS414OOOOOOOOOOOS
SOOOOOOOOO1OOOOOOO2OOS
SOOOOOSOOOOO4OOOOOOOOS
SSSSSSSSSSSSSSSSSSSSSS