SSSSSSSSSSSSSSSSSSSSSS
SOOOOOOOOO1OOOS4OOOO4S
SOOOOO1OOOOOOOSSSOSSSS
SSSSSOSSSSOOOOOOOOOOOS
S1OOOOOOOOOOOOOOOOOOOS
SSSSSSSSSSSSOSOSOSSSSS
SOSSOSO4OOOSOSOOOSSS4S
SOOSOSSSSSOS4SSSSSOSOS
SOO1OOOOOOOOOOO1OOOOOS
SOSSSSOOOOOOOSSSSSSSSS
SOSOOSOOO1OOOSO4OOO4OS
S1SOOSOOOOOOOSOOOS4OOS
SSSSSSSOOOOOOSOOOOOOOS
3OOOOOO1OOOOOSSSSSOSSS
SOSOOOOOOOOOOOO1OOOO4S
SOSSSSSOOSSSSOOOOOOOOS
SOSOOO1OOSO4OOOOOOOOO3
SOOOSS4SOSSSS1OOOOOOOS
SOSSSSSSOOOOOOOOOO144S
S2S4OOOOOOOOOOOO1OOOOS
SSSSSSSSSSSSSSSSSSSSSS