SSSSSSSSSSSSSSSSSSSSSS
SOOOOOOOOOOOO1SOOOOOOS
SOOO2OOOOO44OOSOO4OOOS
SSSSSSSOOOOOOOSOOOOOOS
SOOOOOOOOO1OOOSSSSSS1S
SOOO4O4OOOOOOO1S1OOOOS
SOOOOOOSOOO1OOOSSSSOOS
SSSSSSOSOOOOOOOOOOOO3S
SOOOOOOSOOSSSSOOOOOOOS
SOOOSOOO4OOOSOOOOOOOOS
SOOOSOOOOOOOSOOOOOOOOS
SSSSSSSSSS4SSSSSSSSSSS
SOOOOOOOSS1S1OOOOOOOOS
SOOOSSSSSOOS44OOO1OOOS
SOOOSOOOOOOSSSSSSOOOOS
SOOOOOOSSSOOOOOOOOOOOS
SSSSSSS4O4O1OOSSSSSSSS
S3OOOOOOOOOOOOOOOOOOOS
SOOOOOSOOO1OOOOOOO4OOS
SOOOOOSOOOOO4OOO1OOOOS
SSSSSSSSSSSSSSSSSSSSSS