5555555555555555
5555555555555OO5
5433335OOOOO55O5
5OOOOOOO555OOOO5
555555555O5555O5
5OOO55555O5555O5
555OOOOOOOOO55O5
535O55555O5OOOO5
5O5555555O5555O5
5O555OOOOO5555O5
5O555O55555555O5
5O555O555O555555
5OOOOOOOOOOOOO25
5555555555555555