5555555555555555
5OOOOOOOOOOOO325
5O5555555555O5O5
5OOOOOOOOOO5O5O5
5555555553O5O5O5
5OOOOOOOOOO5O5O5
5O5555555555O5O5
5O5OOO5OOO55O5O5
5O5O5OOO5OO5O5O5
5O5O55555555O5O5
5O5OOOOOOOOOO5O5
5O5O35555555O5O5
545OOOOOOOO5OOO5
5555555555555555