5555555555555555
55OOOOO555OOOO45
55O555O555O55555
55O5O5OOOOOOO535
55O5O5555O5555O5
5OOOOOO5555OOOO5
5O5555O5555O5555
5OOOO5OOOOOOOOO5
555555O5555O55O5
5OOOOOOOOOOOOOO5
5O5555O555O555O5
5O5O55O555O55555
525OOOOO3OOOOOO5
5555555555555555