5555555555555555
5555555O455OOO35
5OOOOOOO5O5O5555
5O55O5555O5OOOO5
5O55O555OO5555O5
5553O555O555OOO5
5OOOO555O555O555
5O555555O555O555
5O3OOOOOOOOOOOO5
5O5O5555O555O555
5O5OOOO5O555O555
5O5555O5O555O555
5OOOOOO52555O555
5555555555555555