5555555555555555
5OOOOOOOOOOOOOO5
5O555555555555O5
5O5OOOOOOOOOO5O5
5O555O555O55O5O5
5O555O555355O5O5
5O555O555O55O5O5
52OOOOOOOOOOO345
5O555O5O5555O555
5O55555O5555O555
5OOOOOOO5555O555
5O55555O5555O555
5OOOOOOOOOOOOO35
5555555555555555