5555555555555
5OOOOOOOO5OO5
5OOOOOOOOOOO5
5OOO2OOO5O155
555O5OOO55555
5OOOOOOO5O1O5
5OOOOOOOOOO55
5OOOOOOOOOO55
5555555555555