5555555555555
552OOOOOOOO55
5555OOOOOOO55
5555O1OOOOOO5
5555OOOOOOOO5
5OOOOOO5O5555
5OO1OOOOOOO15
5OOOOOOOOOOO5
5555555555555