55555555555
5OOO5OOOOO5
5O511O55O15
5OOO1OOOOO5
555551OOOO5
55OOOOOOOO5
55OO5OO5O25
55OO5OO5O15
55555555555