555555555
55O1OOOO5
55OOO12O5
5OOOO5OO5
55515OOO5
555OOO5O5
5551OOOO5
555555555