5555555555555
552OOOOOOOO55
55551OOOOOO55
5555O1OOOOOO5
5555OOOOOOOO5
5OO1OOO515555
5OO1OOOOOOO15
5OOOOOOOOOOO5
5555555555555