555555555
55O1OOOO5
55OOOO2O5
5OOOO5OO5
555O5OOO5
555OOO5O5
5551OOOO5
555555555