5555555555555
5OOOOOOOO5OO5
5OOO1OOOOOOO5
5OOO2O1O5O155
555O51OO55555
5OOOOOOO5O1O5
5O1OOOOOOOO55
5OOOOOOOOOO55
5555555555555