55555555555
5OOO5OOOOO5
5O51OO55OO5
5OOOOOOOOO5
555551OOOO5
55OOOOOOOO5
55OO5OO5O25
55OO5OO5O15
55555555555