wwwwwwwwwwwwwwwwwwww
w..c...............w
w..................w
w.........q........w
w..................w
w....A...........b.w
w....wwww..........w
w.......w..........w
w..................w
w..................w
w.........c..s.....w
w.s..b.............w
w............w.....w
w..................w
w....q.c...........w
wg..q...........g..w
w..................w
w..................w
w................c.w
wwwwwwwwwwwwwwwwwwww