wwwwwwwwwwwwwwwwwwww
w..................w
w..............c...w
w.........q........w
w....wwwww.......g.w
w...c.....A........w
w..................w
w....b.c...........w
w.....s............w
w.................qw
w..................w
w..................w
w...cs.............w
w...g..............w
w..................w
w..................w
w..................w
w..................w
w.....s......c.....w
wwwwwwwwwwwwwwwwwwww