wwwwwwwwwwwwwwwwwwww
w......q...........w
w..................w
w...A..............w
w......w...........w
w................s.w
w..................w
wg.................w
w....g...........b.w
w..................w
w..................w
w....s.............w
w............s.....w
w............c.....w
w..s...............w
w.................sw
wwww...............w
w.........s.c......w
wq...........q.....w
wwwwwwwwwwwwwwwwwwww