wwwwwwwwwwwwwwwwwwww
w.......c..........w
w...........b......w
w..................w
w..................w
w................q.w
w.......c..........w
w..................w
w...........b......w
w.......s.......s..w
w...c..............w
w..................w
w.ww...............w
w..w.s.........A...w
w.qww..............w
w.......c..g.......w
w................g.w
w..................w
w.....w............w
wwwwwwwwwwwwwwwwwwww