wwwwwwwwwwwwwwwwwwww
w...c..............w
w..................w
w...c..............w
w......www.........w
w..................w
w..................w
wc..........c......w
w..g...........s...w
w.c................w
w...............s..w
w..................w
w................q.w
w...........c......w
w..................w
w...A..............w
w..................w
w.............q.gq.w
w...............q.ww
wwwwwwwwwwwwwwwwwwww