wwwwwwwwwwwwwww
w++++++++++l++w
w+++++++3+++_+w
w+++++++++++++w
w+x++++++++++lw
w++1++++++++_+w
w+33+++++3+++-w
w3_++++++_+g++w
w+++++++++++++w
w+++++0+++++++w
w+++++++++++++w
w+++++++++++++w
w++A++wwww++-+w
w+++g+++++++++w
w+++++++++++++w
wwwwwwwwwwwwwww