wwwwwwwwwwwwwwww
w++3+++++++++++w
w+++_++++++++g+w
w+++++++g++++g+w
w++3+++++++++++w
w++_+l++g++g+++w
w+++++++x++++++w
w+++++++++++++3w
w+++++++++++++Aw
w++-+++++++++++w
w++x+++++g+++++w
w+++++++++++++3w
w+1++wwwww+++++w
w+++++++++++_xlw
wwwwwwwwwwwwwwww