wwwwwwwwwwwwwwww
w+++3++l++++g++w
w+++_+++++3++++w
w+++++++++++g++w
w+x-++++++++g++w
w++++++++++_+++w
w++++++++++++++w
w++++++++++++++w
w++++1+++www+++w
w_+++g+++-+++++w
w+++++g++_+++++w
w3++++++++wx+++w
w++++g+++++++++w
w++++A+++++++++w
wwwwwwwwwwwwwwww