wwwwwwwwwwwwwwwww
w+++++++++++l+++w
w+++++++++++l+++w
w+++++++++++l_++w
w+++++++++++3+-gw
w+g+++++++++++g+w
w++++++++++++1++w
w+++++++++++++-+w
w+++++++++++++w+w
w3++3+++++++++++w
w+++++++++++++++w
w+g+++++++3+3+++w
w+++++++++++++_+w
w+++++++A+++++++w
w+++++++++++++++w
w++1++x+++++++++w
wwwwwwwwwwwwwwwww