wwwwwwwwwwwwwwww
w+++++l++++++++w
w+++l++++++++++w
w++++++w+++g+++w
w+gwwwww+++0+l+w
w+++++x++++++++w
w+-++++1+++++++w
w++++++++++++++w
w+++++++0++1+++w
w++++++3+++++++w
w+3+++++0++_+++w
w+_++++++++wwwww
w+++l++++0+++++w
w++++++++g++A++w
wwwwwwwwwwwwwwww