wwwwwwwwwwww
w..........w
w...g......w
w.3..1.+...w
w..........w
w..........w
w..2.2.....w
w..........w
wwwww..A...w
w..........w
w.....gw...w
wwwwwwwwwwww