wwwwwwwwwwwww
w...........w
w.2.........w
w.....+.....w
w.......2...w
w...A.w.....w
w..wwwwg....w
w...........w
w...2.......w
w.........2.w
w.2.........w
w2....3..2.gw
wwwwwwwwwwwww