wwwwwwwwwwww
w.w........w
w.wwww..1..w
w..........w
wg.......A.w
w....+.www.w
w..........w
w.......3..w
w3.........w
w...2.+....w
w.2........w
wwwwwwwwwwww