wwwwwwwwwwww
w3.....1...w
w........+.w
w..........w
w..........w
w.........Aw
w2......wwww
w..........w
w........2.w
w..........w
w23.....ww.w
w....g...2.w
wwwwwwwwwwww