wwwwwwwwwwwww
w..3........w
w.......+...w
w1.........2w
w.A.1.......w
w.....wwwww.w
w...........w
w...........w
w...........w
w...........w
w..wwww.....w
w.g.........w
wwwwwwwwwwwww