wwwwwwwwwwwwwww
w...qw........w
w.w.........www
wwwwww...wwwqqw
www.........qqw
www..g......Aqw
www......qq.www
wwwwww...www.qw
www...........w
www.........www
www.........q.w
www.........ccw
w.....csc..wwww
w..w..ssb..wwww
wwwwwwwwwwwwwww