wwwwwwwwwwwwwww
wwwg+w++4wwwwww
www++w++++++www
www++++_l+++www
www+++0+3_-1gww
www++++=_1=+=ww
w++4++++++++www
w++4++++++++www
w++++4++++++www
wwwwww+++A++www
wwwwww++++++www
wwwwwwwwwwwwwww