wwwwwwwwwwwwwww
w..213...w....w
w.+wwwwwwwww..w
w.............w
www......w....w
w.............w
w...+.........w
www...........w
w..www........w
w...........www
w...........www
w...........gww
ww..w.wwwwwwwww
ww+Aw.wwwwwwwww
wwwwwwwwwwwwwww