wwwwwwwwwwwwwww
wwwwwwwww...www
wwwwwwwww...www
w.............w
w.............w
www+++331.....w
w++www..w..w..w
w+A..wwww..w..w
w++..w.....w..w
www...+++...www
www...........w
wwwg..+++.....w
www.........www
www.........www
wwwwwwwwwwwwwww