wwwwwwwwwwwwwww
www++g+++x=1www
wwwwww+++00Bwww
w+w+++++++++www
w+++g+++++++www
www+++www_+wwww
www++2+++www++w
wwww+++++ww2++w
www+++w++ww+++w
www++++++__3www
www++++++133www
wwwwwwwwwwwwwww
