wwwwwwwwwwww
www+.++++www
www+++wwwwww
www++++++www
w44x--wwwxww
www++++g+=ww
w+4++++++++w
w4+www+++++w
w+4www+A+++w
wwg++++++++w
wwg+4++++4+w
wwg.24+++++w
www+ww+++www
www+ww+++13w
wwwwwwwwwwww
