wwwwwwwwwwww
www+ww.g...w
www.ww...www
w.......+..w
w.....+....w
w.....www..w
www..Ag22w.w
www..+gg+w.w
www..+gggwgw
w........w.w
w.+.....ww.w
w3+ww....w.w
wwwww.332www
www......www
wwwwwwwwwwww
