wwwwwwwwwwwwwww
www....g.111www
www......wwwwww
w.....w+A.....w
w.....w++.....w
w..wwww++.....w
www...........w
www...+++.....w
www.+.........w
w++..........3w
w++.........23w
w++..........3w
www......wwwwww
www......wwwwww
wwwwwwwwwwwwwww
