wwwwwwwwwwwwwww
www......wwwwww
www...233...www
www..+113...w.w
www..+ww+...w.w
www.ww21+...wAw
w.............w
w.....www.....w
w..wwwwww....ww
wwgwww.w......w
wwgw32...w..www
wwg.3w.ww....+w
wwww......+.www
www......+..www
wwwwwwwwwwwwwww
